Astronomy Domine - Pink Floyd
Set the Controls for the Heart of the Sun - Pink Floyd
Riders on the Storm - The Doors
Epitaph - King Crimson
Feels Like We Only Go Backwards - Tame Impala
Do You Realize?? - The Flaming Lips
Space Is Deep - Hawkwind
Roundabout - Yes
Halleluhwah - Can
In-A-Gadda-Da-Vida - Iron Butterfly
Breathe - Pink Floyd
White Rabbit - Jefferson Airplane
Tomorrow Never Knows - The Beatles
Dark Star - Grateful Dead
Tales of Brave Ulysses - Cream
Third Stone from the Sun - Jimi Hendrix
Venus in Furs - The Velvet Underground
Albatross - Fleetwood Mac
Rattlesnake - King Gizzard & The Lizard Wizard
The Musical Box - Genesis
Echoes - Pink Floyd
Baba O'Riley - The Who
Nights in White Satin - The Moody Blues
Pyramid Song - Radiohead
Space Oddity - David Bowie
No Quarter - Led Zeppelin
Soul Sacrifice - Santana
10538 Overture - Electric Light Orchestra
Fool's Overture - Supertramp
Pink Moon - Nick Drake
Dear Mr. Fantasy - Traffic